ID,等级,前置,其他,留空列
1-1,1,无,无,
1-2,2,无,无,
1-3,3,无,无,
1-4,4,无,无,
1-5,5,无,无,
1-6,6,无,无,
1-7,7,无,无,
